############################
#                          #
#   ##        ##           #
#                          #
#        ####              #
#                          #
#              ##          #
#                          #
#   ###                    #
#                          #
#                    ###   #
#                          #
############################
