#############################################
#         #                                 #
#         #                                 #
#         #                                 #
#         #                                 #
#         #                                 #
#         #                                 #
#         #                                 #
#                    #                      #
#                    #                      #
#                    #                      #
#                    #                      #
#                    #                      #
#                    #                      #
#                    #                      #
#                                           #
#                                           #
#                                           #
#                                  #        #
#                                  #        #
#                           ########        #
#                                           #
#                                           #
#############################################
